Map1
1  1  1  1  1  1  1  1  1  1  1  1  1  1  1  1  1  1  1  1  1  1  1  1  1  1  1  1  1  1  1  1
1  0  0  0  0  0  0  0  0  7  0  0  0  0  0  0  0  0  0  0  0  0  0  0  0  0  0  0  0  0  0  1
1  0  0  0  0  0  0  0  0  0  0  0  0  0  0  0  0  0  0  0  0  0  0  0  0  0  0  0  0  0  0  1
1  0  0  0  0  0  0  0  12 1  13 0  0  0  0  7  0  8  0  0  0  0  0  0  0  0  0  0  0  0  0  1
1  0  8  0  0  0  0  1  1  1  1  1  13 0  0  0  0  0  0  0  0  12 1  1  13 0  9  0  0  10 0  1
1  0  0  0  0  0  0  0  0  1  1  1  1  1  1  1  1  1  1  1  1  1  1  1  1  1  1  1  1  1  1  1
1  1  1  1  0  0  0  0  0  1  1  1  1  1  0  0  11 0  0  0  0  0  0  0  0  0  0  0  0  0  0  1
1  1  1  1  0  0  0  0  0  0  0  0  0  0  0  0  0  0  0  0  0  0  0  0  0  0  0  0  0  0  0  1
1  1  1  1  0  0  0  0  0  0  0  0  0  0  0  0  1  1  1  1  1  1  1  13 0  2  0  0  0  0  0  1
1  1  1  1  1  1  1  1  1  1  1  1  1  1  1  1  1  1  1  1  1  1  1  1  1  1  1  1  3  3  3  1
1  0  0  0  7  0  0  0  0  0  0  0  0  0  0  0  0  0  0  0  0  0  0  1  1  1  1  1  0  0  0  1
1  0  0  0  0  0  2  0  0  0  0  8  0  0  0  0  0  0  0  0  0  0  0  0  0  0  0  0  0  0  0  1
1  0  0  0  12 1  1  1  1  13 0  0  0  0  0  0  0  0  0  0  0  0  0  0  0  0  0  0  0  0  0  1
1  0  0  1  1  1  1  1  1  1  1  1  1  1  1  1  1  1  1  1  1  1  1  1  1  1  1  1  0  0  0  1
1  0  0  0  0  0  0  0  0  0  0  0  0  0  0  0  0  0  0  0  0  0  0  0  0  0  0  1  1  1  1  1
1  0  0  0  0  0  0  0  0  0  0  0  0  0  0  0  0  0  0  0  0  0  0  0  0  0  0  0  1  1  1  1
1  1  1  1  1  1  1  1  1  1  1  1  1  1  13 0  0  0  0  0  0  0  0  0  0  0  0  0  0  1  1  1
1  0  0  0  0  0  0  0  0  0  0  0  1  1  1  13 0  0  0  0  0  0  0  0  0  0  0  0  0  0  0  1
1  0  0  0  0  0  0  0  0  0  0  0  0  0  1  1  1  1  1  1  1  1  6  6  6  1  1  0  0  0  0  1
1  0  0  0  0  0  0  0  0  0  0  0  0  0  0  0  0  0  0  1  1  0  0  0  0  0  0  0  0  0  0  1
1  1  1  1  1  1  1  1  1  1  0  0  0  0  0  0  0  0  0  0  0  0  0  0  0  0  0  0  0  0  0  1
1  0  0  0  0  0  0  0  0  0  0  0  0  0  0  7  0  0  0  0  0  0  0  0  8  0  0  0  0  1  1  1
1  0  0  0  0  0  0  0  0  0  0  0  0  0  0  0  0  0  0  0  0  0  0  0  0  0  0  0  0  1  1  1
1  1  1  1  1  1  1  1  1  1  1  1  1  1  4  4  4  1  1  1  1  1  1  5  5  5  1  1  1  1  1  1


Map2
1  1  1  1  1  1  1  1  1  1  1  1  1  1  1  1  1  1  1  1  1  1  1  1  1  1  1  1  1  1  1  1
1  0  0  0  0  0  0  0  0  0  0  0  0  0  0  0  0  0  0  0  0  0  0  0  0  0  0  0  0  0  0  1
1  0  0  0  0  0  0  0  0  0  0  0  0  0  0  0  7  0  8  0  0  0  0  0  0  0  0  0  0  0  0  1
1  0  9  0  0  10 0  0  0  0  0  0  0  0  0  0  0  0  0  0  0  0  0  0  0  0  0  0  0  0  0  1
1  1  1  1  1  1  1  1  1  1  1  1  1  1  1  0  0  0  0  1  1  1  1  13 0  0  0  0  0  0  0  1
1  0  0  0  0  0  0  0  0  0  0  0  0  0  0  0  0  0  0  0  0  0  0  1  13 0  0  0  0  0  0  1
1  0  0  0  0  0  0  0  0  0  0  0  0  0  0  0  0  0  0  0  0  0  0  1  1  1  0  0  0  0  0  1
1  0  0  0  0  0  0  0  0  0  0  0  0  0  0  0  0  0  0  0  0  0  0  0  0  0  0  0  0  0  0  1
1  0  0  0  0  0  0  0  0  0  0  0  0  0  0  0  0  0  0  0  0  0  0  0  0  0  0  0  1  1  1  1
1  0  0  0  0  0  0  0  0  0  0  0  0  0  0  0  0  0  0  0  0  0  0  0  0  0  0  0  1  1  1  1
1  0  0  0  0  0  0  0  0  0  14 14 14 0  0  0  7  8  0  0  14 14 14 0  0  0  0  0  1  1  1  1
1  0  0  0  0  0  0  0  0  0  0  0  0  0  0  0  0  0  0  0  0  0  0  0  0  0  1  1  1  1  1  1
1  0  0  0  0  0  0  0  0  0  0  0  0  0  0  1  1  1  1  0  0  0  0  0  0  0  1  1  1  1  1  1
1  0  0  0  0  0  1  1  6  6  6  6  6  6  6  1  1  16 1  6  6  6  6  6  1  1  1  1  1  1  1  1
1  0  0  0  0  0  0  0  0  0  0  0  0  0  0  0  0  16 0  0  0  0  0  0  0  0  0  0  0  0  0  1
1  1  1  1  0  0  0  0  8  0  0  7  0  0  0  0  0  16 0  0  0  8  0  0  7  0  0  0  0  0  0  1
1  1  1  1  0  0  15  0  0  0  0  0  0  0  0  0  0 16 0  0  0  0  0  0  0  0  15 0  0  0  0  1
1  1  1  1  1  1  1  1  1  1  1  1  1  1  1  1  1  1  1  1  1  1  1  1  1  1  1  1  13 0  0  1
1  0  0  0  0  0  8  0  0  0  8  0  0  0  0  0  0  7  0  0  0  7  0  0  0  0  0  0  0  0  0  1
1  0  0  0  0  0  0  0  0  0  0  0  0  0  0  0  0  0  0  0  0  0  0  0  0  0  0  0  0  0  0  1
1  0  0  0  0  5  5  5  5  5  5  5  0  0  0  0  4  4  4  4  4  4  4  0  0  0  0  0  0  0  0  1
1  0  0  0  0  0  7  0  0  0  7  0  0  0  0  0  0  8  0  0  0  8  0  0  0  0  0  0  0  1  1  1
1  0  0  0  0  0  0  0  0  0  0  0  0  0  0  0  0  0  0  0  0  0  0  0  0  0  0  0  0  1  1  1
1  1  1  1  1  4  4  4  4  4  4  4  1  1  1  1  5  5  5  5  5  5  5  1  1  1  1  1  1  1  1  1


Map3
1  1  1  1  1  1  1  1  1  1  1  1  1  1  1  1  1  1  1  1  1  1  1  1  1  1  1  1  1  1  1  1
1  0  0  0  0  0  0  0  0  0  8  0  0  0  0  0  0  0  0  0  0  7  0  0  0  0  0  0  0  0  0  1
1  0  0  0  0  0  0  0  0  0  0  0  0  0  0  0  0  0  0  0  0  0  0  0  0  0  0  0  0  0  0  1
1  0  0  0  1  1  1  1  1  1  1  1  1  1  1  0  0  1  1  1  1  1  1  1  1  1  1  1  0  0  0  1
1  0  0  0  0  0  0  1  0  0  0  0  0  0  0  0  0  0  0  0  0  0  0  0  1  0  0  0  0  0  0  1
1  0  0  0  0  0  0  1  0  0  0  0  0  0  0  0  0  0  0  0  0  0  0  0  1  0  0  0  0  0  0  1
1  0  0  0  0  0  0  1  0  0  0  0  0  8  0  12 13 0  7  0  0  0  0  0  1  0  0  0  0  0  0  1
1  0  0  0  0  0  0  1  0  0  0  0  0  0  12 1  1  13 0  0  0  0  0  0  1  0  0  0  0  0  0  1
1  0  0  0  0  0  0  1  7  0  0  0  0  12 1  1  1  1  13 0  0  0  0  8  1  0  0  0  0  0  0  1
1  0  0  0  0  0  0  1  0  0  0  0  0  1  1  1  1  1  1  0  0  0  0  0  1  0  0  0  0  0  0  1
1  0  0  0  0  0  0  1  4  4  1  0  0  0  0  1  1  0  0  0  0  1  5  5  1  0  0  0  0  0  0  1
1  17 17 17 0  0  0  1  0  0  0  0  0  0  0  1  1  0  0  0  0  0  0  0  1  0  0  0  17 17 17 1
1  1  1  1  1  0  0  1  0  0  0  0  0  0  0  1  1  0  0  0  0  0  0  0  1  0  0  1  1  1  1  1
1  0  0  0  0  0  0  1  0  0  0  0  0  0  0  1  1  0  0  0  0  0  0  0  1  0  0  0  0  0  0  1
1  0  0  0  0  0  0  1  0  9  0  0  0  0  0  1  1  0  0  0  0  0  10 0  1  0  0  0  0  0  0  1
1  0  0  0  0  12 1  1  1  1  1  1  1  1  1  1  1  1  1  1  1  1  1  1  1  1  13 0  0  0  0  1
1  1  1  0  0  0  8  0  0  8  0  0  0  0  0  0  0  0  0  0  0  0  7  0  0  7  0  0  0  1  1  1
1  1  1  0  0  0  0  0  0  0  0  0  0  0  0  0  0  0  0  0  0  0  0  0  0  0  0  0  0  1  1  1
1  1  1  1  1  5  5  5  5  5  5  1  1  1  0  0  0  0  1  1  1  4  4  4  4  4  4  1  1  1  1  1
1  0  0  0  0  0  0  0  0  0  0  0  0  0  0  0  0  0  0  0  0  0  0  0  0  0  0  0  0  0  0  1
1  0  0  0  0  0  0  0  0  0  0  0  7  0  0  0  0  0  0  0  8  0  0  0  0  0  0  0  0  0  0  1
1  0  98 0  0  0  7  0  0  7  0  0  0  12 1  1  1  1  13 0  0  0  8  0  0  8  0  0  0  99 0  1
1  0  0  0  0  0  0  0  0  0  0  0  12 1  1  1  1  1  1  13 0  0  0  0  0  0  0  0  0  0  0  1
1  1  1  1  1  4  4  4  4  4  4  1  1  1  1  1  1  1  1  1  1  5  5  5  5  5  5  1  1  1  1  1


Map4
1  1  1  1  1  1  16 1  1  1  1  1  1  1  1  1  1  1  1  1  1  1  1  1  1  1  1  1  1  1  1  1
1  0  7  0  0  0  16 0  0  0  0  0  0  0  0  0  0  0  0  0  0  1  0  0  0  0  0  0  0  0  0  1
1  0  0  0  0  0  16 0  0  0  0  0  0  0  0  0  0  0  0  0  0  1  0  0  0  0  0  11 0  99 0  1
1  0  0  0  20 0  16 0  0  0  0  0  0  0  0  0  0  0  0  0  0  1  0  0  0  0  0  0  0  0  0  1
1  1  1  1  1  1  1  1  1  1  0  0  0  0  0  0  0  0  0  0  0  1  0  0  0  12 1  1  1  1  1  1
1  0  0  0  0  0  0  0  0  0  0  0  0  0  0  1  1  1  1  0  0  1  18 18 18 1  0  0  0  0  0  1
1  0  0  0  0  0  0  0  0  0  0  0  0  1  1  1  0  0  0  0  0  1  0  0  0  1  0  0  0  0  0  1
1  0  0  0  0  0  0  0  0  0  0  0  0  1  0  0  0  0  0  0  0  1  0  0  0  1  0  0  0  0  0  1
1  0  0  0  12 1  1  4  4  4  4  1  1  1  0  0  0  0  0  0  0  1  0  0  0  1  0  15 0  0  0  1
1  19 19 19 1  0  0  0  0  0  0  1  0  0  0  0  0  0  0  1  1  1  0  0  0  1  1  1  1  0  0  1
1  0  0  0  1  0  0  0  0  0  0  1  0  0  0  0  0  0  0  0  0  1  0  0  0  0  0  0  0  0  0  1
1  0  0  0  1  0  0  0  0  0  0  1  0  7  0  0  1  1  0  0  0  1  0  0  0  0  0  0  0  8  0  1
1  0  0  0  1  0  0  0  0  0  0  1  0  0  0  0  0  0  0  0  0  1  0  0  0  0  0  0  0  0  0  1
1  0  0  0  1  0  0  0  0  0  0  1  1  1  1  0  0  0  0  0  0  1  0  0  0  0  0  0  0  1  1  1
1  0  0  0  1  0  0  0  0  0  0  0  0  0  0  0  0  0  0  0  0  1  19 19 19 0  0  0  0  0  0  1
1  0  0  0  1  0  0  0  0  0  0  0  0  0  0  0  0  0  0  0  0  1  1  1  1  1  1  1  0  0  0  1
1  0  0  0  1  0  0  0  0  0  0  0  0  0  0  0  0  8  0  0  0  0  0  0  0  0  0  0  0  0  0  1
1  0  0  0  1  0  0  0  0  0  0  0  0  0  0  0  0  0  0  0  8  7  0  0  0  0  0  0  0  0  0  1
1  0  0  0  1  0  9  0  0  10 0  0  0  0  7  0  0  0  0  0  0  0  0  0  0  0  0  0  0  0  0  1
1  98 0  0  1  1  1  1  1  1  1  21 0  0  0  0  0  0  0  1  1  1  1  0  0  0  8  0  0  0  0  1
1  0  0  0  0  0  1  1  1  1  1  0  0  1  1  1  0  0  0  0  0  0  0  0  0  0  0  0  12 1  1  1
1  0  0  0  0  0  1  1  1  1  1  0  0  0  0  0  0  0  0  0  0  0  0  0  0  1  1  1  1  1  1  1
1  18 18 18 1  1  1  1  1  1  1  6  6  6  6  6  6  6  6  6  6  6  6  6  6  1  1  1  1  1  1  1
1  1  1  1  1  1  1  1  1  1  1  1  1  1  1  1  1  1  1  1  1  1  1  1  1  1  1  1  1  1  1  1

Map5
1  1  1  1  1  1  1  1  1  1  1  1  1  1  1  1  1  1  1  1  1  1  1  1  1  1  1  1  1  1  1  1
1  0  0  0  0  0  0  0  0  0  0  0  0  0  0  0  0  0  0  0  0  0  0  0  0  0  11 0  0  0  0  1
1  0  0  0  0  0  0  0  0  0  0  0  0  0  0  0  0  0  0  0  0  0  0  0  0  0  0  0  0  0  0  1
1  0  0  0  0  0  0  0  12 1  1  1  1  0  0  0  0  0  0  0  0  0  0  0  0  0  0  1  1  0  0  1
1  0  9  0  0  10 0  12 1  0  0  0  0  0  0  0  0  0  0  0  0  0  0  0  0  0  0  0  0  0  0  1
1  1  1  1  1  1  1  1  0  0  0  0  0  0  0  0  0  0  0  0  0  0  0  0  0  0  0  0  0  0  0  1
1  0  0  0  0  0  0  0  0  0  0  0  0  0  0  0  0  0  0  0  0  0  0  0  0  0  0  0  0  1  1  1
1  0  0  0  0  0  0  0  0  0  0  0  0  0  0  0  0  0  0  0  0  0  0  0  0  0  0  0  0  1  1  1
1  0  0  0  0  12 1  1  1  13 0  0  12 1  1  1  1  1  1  1  1  1  1  1  1  1  1  1  1  1  1  1
1  0  0  0  12 1  0  0  0  1  1  1  1  0  0  0  0  0  0  0  0  0  0  0  0  0  0  0  0  0  0  1
1  0  0  0  1  0  0  0  0  0  0  0  0  0  0  0  0  0  0  0  0  0  0  0  0  0  0  0  0  0  0  1
1  0  0  0  1  0  0  0  0  0  0  0  0  0  0  0  0  0  0  0  0  0  0  0  0  0  0  0  0  0  0  1
1  0  0  0  0  0  0  12 1  1  1  1  13 0  0  0  0  0  0  0  0  0  0  0  0  0  0  0  0  0  0  1
1  0  0  0  0  0  12 1  0  0  0  0  1  13 0  0  0  0  0  0  0  0  0  0  0  0  0  0  0  0  0  1
1  0  0  0  0  12 1  0  0  0  0  0  0  1  13 0  0  0  0  0  12 1  1  1  13 0  0  0  0  0  0  1
1  17 17 17 1  1  0  0  0  0  0  0  0  0  1  1  1  1  1  1  1  0  0  0  1  1  1  0  0  0  0  1
1  0  0  0  0  0  0  0  0  0  0  0  0  0  0  0  0  0  0  0  0  0  0  0  0  0  0  0  0  0  0  1
1  0  0  0  0  0  0  0  0  0  0  0  0  0  0  0  0  0  0  0  0  0  0  0  0  0  0  0  0  1  1  1
1  0  0  0  0  0  0  0  0  0  0  0  0  0  0  0  0  0  0  0  0  0  0  0  0  0  0  0  0  0  0  1
1  0  0  0  0  0  0  0  0  0  0  0  1  1  0  0  0  0  0  0  0  1  1  1  0  0  0  0  0  0  0  1
1  99 0  98 0  0  0  1  1  0  0  0  0  0  0  0  1  1  1  0  0  0  0  0  0  0  1  1  0  0  0  1
1  0  0  0  0  0  0  0  0  0  0  0  0  0  0  0  0  0  0  0  0  0  0  0  0  0  0  0  0  0  0  1
1  1  1  1  1  1  6  6  6  6  6  6  6  6  6  6  6  6  6  6  6  6  6  6  6  6  6  6  6  6  6  1
1  1  1  1  1  1  1  1  1  1  1  1  1  1  1  1  1  1  1  1  1  1  1  1  1  1  1  1  1  1  1  1

Map98
1  1  1  1  1  1  1  1  1  1  1  1  1  1  1  1  1  1  1  1  1  1  1  1  1  1  1  1  1  1  1  1
1  1  1  1  1  1  1  1  1  1  1  1  1  1  1  1  1  1  1  1  1  1  1  1  1  1  1  1  1  1  1  1
1  1  1  1  1  1  1  1  1  1  1  1  1  1  1  1  1  1  1  1  1  1  1  1  1  1  1  1  1  1  1  1
1  1  1  1  1  1  1  1  1  1  1  1  1  1  1  1  1  1  1  1  1  1  1  1  1  1  1  1  1  1  1  1
1  1  1  1  1  1  1  1  1  1  1  1  1  1  1  1  1  1  1  1  1  1  1  1  1  1  1  1  1  1  1  1
1  0  0  0  0  0  0  0  0  0  0  0  0  0  0  0  0  0  0  0  0  0  0  0  0  0  0  0  0  0  0  1
1  0  0  0  0  0  0  0  0  0  0  0  0  0  0  0  0  0  0  0  0  0  0  0  0  0  0  0  0  0  0  1
1  0  0  0  0  0  0  0  0  0  0  0  0  0  0  0  0  0  0  0  0  0  0  0  0  0  0  0  0  0  0  1
1  0  0  1  1  1  1  1  0  0  0  0  0  0  0  0  0  0  0  0  0  1  1  1  1  1  1  1  1  0  0  1
1  0  0  0  0  0  0  0  0  0  0  0  0  0  0  0  0  0  0  0  0  0  0  0  0  0  0  0  0  0  0  1
1  0  0  0  0  0  0  0  0  0  0  0  0  0  0  0  0  0  0  0  0  0  0  0  0  0  0  0  0  0  0  1
1  0  0  0  0  0  0  0  0  1  1  1  1  1  6  6  6  1  1  1  1  1  0  0  0  0  0  0  0  0  0  1
1  0  0  0  0  0  0  0  0  0  0  0  0  0  0  0  0  0  0  0  0  0  0  0  0  0  0  0  0  0  0  1
1  0  0  0  0  0  0  0  0  0  0  0  0  0  0  0  0  0  0  0  0  0  0  0  0  0  0  0  0  0  0  1
1  0  0  0  0  0  0  0  0  0  0  0  0  0  0  0  0  0  0  0  0  0  0  0  0  0  0  0  0  0  0  1
1  0  0  0  0  0  0  0  0  0  0  0  0  0  0  0  0  0  0  0  0  0  0  0  0  0  0  0  0  0  0  1
1  0  0  0  0  0  0  1  1  1  1  1  0  0  0  0  0  0  0  1  1  1  1  1  0  0  0  0  0  0  0  1
1  0  0  0  0  0  0  0  0  0  0  0  0  0  0  0  0  0  0  0  0  0  0  0  0  0  0  0  0  0  0  1
1  0  0  0  0  0  98 0  0  0  0  0  0  0  0  0  0  0  0  0  0  0  0  0  0  99 0  0  0  0  0  1
1  0  0  0  0  0  0  0  0  0  0  0  0  0  0  0  0  0  0  0  0  0  0  0  0  0  0  0  0  0  0  1
1  0  0  0  0  1  1  1  1  1  1  1  1  1  1  1  1  1  1  1  1  1  1  1  1  1  1  0  0  0  0  1
1  0  0  0  0  0  0  0  0  0  0  0  0  0  0  0  0  0  0  0  0  0  0  0  0  0  0  0  0  0  0  1
1  6  6  6  6  6  6  6  6  6  6  6  6  6  6  6  6  6  6  6  6  6  6  6  6  6  6  6  6  6  6  1
1  1  1  1  1  1  1  1  1  1  1  1  1  1  1  1  1  1  1  1  1  1  1  1  1  1  1  1  1  1  1  1

Map99
1  1  1  1  1  1  1  1  1  1  1  1  1  1  1  1  1  1  1  1  1  1  1  1  1  1  1  1  1  1  1  1
1  0  0  0  0  0  0  0  0  0  0  0  0  0  0  0  0  0  0  0  0  0  0  0  0  0  0  0  0  0  0  1
1  0  0  0  0  0  0  0  0  0  0  0  0  0  0  0  0  0  0  0  0  0  0  0  0  0  0  0  0  0  0  1
1  19 19 19 1  1  1  0  0  0  0  0  0  0  0  0  0  0  0  0  0  0  0  0  0  0  0  0  0  0  0  1
1  0  0  0  0  0  0  0  0  0  0  0  0  0  0  0  0  0  0  0  0  0  0  0  0  0  0  11  0  0  0  1
1  0  0  0  0  0  0  0  0  0  0  0  0  0  0  0  0  0  0  0  0  0  0  0  0  0  0  0  0  0  0  1
1  0  0  0  0  0  0  0  0  0  0  0  0  0  0  0  0  0  0  0  0  0  0  0  0  0  0  0  0  0  0  1
1  0  0  0  0  0  0  0  0  0  0  0  0  0  0  0  0  0  0  0  0  0  0  0  0  0  12 1  1  1  1  1
1  0  0  0  0  0  0  0  0  0  0  0  0  0  0  0  0  0  0  0  0  0  0  18 18 18 0  0  0  0  0  1
1  0  0  0  0  0  0  0  0  0  0  0  0  0  0  0  0  0  0  0  0  0  0  0  0  0  0  0  0  0  0  1
1  0  0  0  0  0  0  0  0  0  0  0  0  0  0  0  0  0  0  0  0  0  0  0  0  0  0  0  0  0  0  1
1  0  0  0  0  0  0  0  0  0  0  0  0  0  0  0  0  0  0  0  0  0  0  0  0  0  0  0  0  0  0  1
1  0  0  0  0  0  0  0  0  0  0  0  0  0  0  0  0  0  0  0  0  0  0  0  0  0  0  0  0  0  0  1
1  0  0  0  0  0  0  0  0  0  0  0  0  0  0  0  0  0  0  0  0  0  0  0  0  0  0  0  0  0  0  1
1  0  0  0  0  0  0  0  0  0  0  0  0  14 14 14 0  0  0  0  0  0  0  19 19 19 0  0  20 0  0  1
1  18 18 18 0  0  0  0  0  0  0  0  0  0  0  0  0  0  0  0  0  0  0  1  1  1  1  1  1  1  1  1
1  1  1  1  0  0  7  0  8  0  0  0  0  0  0  0  0  0  0  0  0  0  0  0  0  0  0  0  0  0  0  1
1  0  0  0  0  0  0  0  0  0  0  0  0  0  0  0  0  0  0  0  0  0  0  0  0  0  0  0  0  0  0  1
1  0  0  0  0  0  0  0  0  0  2  0  0  0  0  0  0  0  0  17 17 17 0  0  0  0  0  0  0  0  0  1
1  6  1  5  1  4  3  3  3  1  1  1  0  0  0  0  1  1  1  1  1  16 1  0  0  0  0  0  0  0  0  1
1  0  0  0  0  0  0  0  0  0  0  0  0  0  0  0  0  0  0  0  0  0  0  0  0  0  0  0  0  0  0  1
1  98 99 0  0  0  0  0  0  0  0  0  0  0  0  0  0  0  0  0  0  0  0  0  0  0  0  0  0  0  0  1
1  0  0  0  2  0  0  0  0  0  0  12 1  1  1  13 0  0  15 0  0  0  0  15 0  0  9  0  0  10 0  1
1  1  1  1  1  1  1  1  1  1  1  1  1  1  1  1  1  1  1  1  1  1  1  1  21 1  1  1  1  1  1  1